{
  "map_1":[
      [10, 10, 10, 10, 10, 10,  9, 17, 18, 9, 10, 10, 10, 10, 10, 10],
      [10,  3, 22,  3,  3,  3,  1, 12, 12, 1,  3,  3,  3, 22,  3, 10],
      [10, 25, 26, 26, 26, 26, 26, 26, 26, 26, 26, 26, 26, 26, 26, 10],
      [10, 25, 26, 26, 26, 26, 26, 26, 26, 26, 26, 26, 26, 26, 26, 10],
      [10, 25, 26, 26, 30, 30, 30, 30, 30, 30, 30, 30, 26, 26, 26, 10],
      [10, 25, 26, 30, 26, 26, 26, 26, 26, 26, 26, 26, 30, 26, 26, 10],
      [10, 25, 26, 26, 30, 30, 30, 26, 26, 30, 30, 30, 26, 26, 26, 10],
      [10, 25, 26, 26, 26, 26, 26, 26, 26, 26, 26, 26, 26, 26, 26, 10],
      [10, 25, 26, 26, 26, 26, 26, 26, 26, 26, 26, 26, 26, 26, 26, 10],
      [10, 25, 26, 26, 26, 26, 26, 26, 26, 26, 26, 26, 26, 26, 26, 10],
      [10, 25, 26, 26, 26, 26, 26, 26, 26, 26, 26, 26, 26, 26, 26, 10],
      [10, 10, 10, 10, 10, 10, 10, 10, 10, 10, 10, 10, 10, 10, 10, 10]
  ],
  "items_1":[
    [-1, -1, -1, -1, -1, -1, -1, -1, -1, -1, -1, -1, -1, -1, -1, -1],
    [-1, -1, 33, -1, -1, -1, -1, -1, -1, -1, -1, -1, -1, 33, -1, -1],
    [-1, -1, -1, -1, -1,  7, -1, -1, -1, -1, -1,  7, -1, -1, -1, -1],
    [-1, -1, -1, -1, -1, -1, -1, -1, -1, -1, -1, -1, -1, -1, -1, -1],
    [-1, -1, -1, -1, -1, -1, -1, -1, -1, -1, -1, -1, -1, -1, -1, -1],
    [-1, -1, -1, -1, -1, -1,  7, -1,  8, -1, -1, -1, -1, -1, -1, -1],
    [-1, -1, -1, -1, -1, -1, -1, -1, -1, -1, -1, -1, -1, -1, -1, -1],
    [-1, -1, -1, -1, -1, -1, -1, -1, -1, -1, -1, -1, -1, -1, -1, -1],
    [-1, -1, -1, -1, 32, -1, -1, -1, -1, -1, -1, -1, 31, -1, -1, -1],
    [-1, -1, -1, -1, -1, -1, -1, -1, -1,  7, -1, -1, -1, -1, -1, -1],
    [-1, -1, -1, -1, -1, -1, -1, -1, -1, -1, -1, -1, -1, -1, -1, -1],
    [-1, -1, -1, -1, -1, -1, -1, -1, -1, -1, -1, -1, -1, -1, -1, -1] 
  ],
  "scroll_1":"Such is the truth and the truth is this:\nYou are hurting, but be warned, it is here that you will feel the utmost pain. Your suffering isn't a punishment.",
  "map_2":[
    [10, 10, 10, 10, 10, 10,  9, 17, 18, 9, 10, 10, 10, 10, 10, 10],
    [10,  3, 22,  3,  3,  3,  1, 12, 12, 1,  3,  3,  3, 22,  3, 10],
    [10, 25, 26, 26, 26, 26, 26, 26, 26, 26, 26, 26, 26, 26, 26, 10],
    [10, 25, 26, 26, 30, 30, 30, 30, 30, 30, 30, 26, 26, 26, 26, 10],
    [10, 25, 26, 26, 30, 30, 30, 30, 30, 30, 30, 30, 26, 26, 26, 10],
    [10, 25, 26, 30, 26, 26, 26, 26, 26, 26, 26, 26, 30, 26, 26, 10],
    [10, 25, 26, 26, 30, 30, 30, 26, 26, 30, 30, 30, 26, 26, 26, 10],
    [10, 25, 26, 26, 26, 26, 26, 26, 26, 26, 26, 26, 26, 26, 26, 10],
    [10, 25, 26, 26, 26, 26, 26, 26, 26, 26, 26, 26, 26, 26, 26, 10],
    [10, 25, 26, 26, 26, 26, 26, 26, 26, 26, 26, 26, 26, 26, 26, 10],
    [10, 25, 26, 26, 26, 26, 26, 26, 26, 26, 26, 26, 26, 26, 26, 10],
    [10, 10, 10, 10, 10, 10, 10, 10, 10, 10, 10, 10, 10, 10, 10, 10]
  ],
  "items_2":[
    [-1, -1, -1, -1, -1, -1, -1, -1, -1, -1, -1, -1, -1, -1, -1, -1],
    [-1, -1, 33, -1, -1, -1, -1, -1, -1, -1, -1, -1, -1, 33, -1, -1],
    [-1, -1, -1, -1, -1,  7, -1, -1, -1, -1, -1,  7, -1, -1, -1, -1],
    [-1, -1, -1, -1, -1, -1, -1, -1, -1, -1, -1, -1, -1, -1, -1, -1],
    [-1, -1, -1, -1, -1, -1, -1, -1, -1, -1, -1, -1, -1, -1, -1, -1],
    [-1, -1, -1, -1, -1, -1,  -1, -1, 8, -1, -1, -1, -1, -1, -1, -1],
    [-1, -1, -1, -1, -1, -1, -1, -1, -1, -1, -1, -1, -1, -1, -1, -1],
    [-1, -1, -1, -1, -1, -1, -1, -1, -1, -1, -1, -1, -1, -1, -1, -1],
    [-1, -1, -1, -1, 32, -1, -1, -1, -1, -1, -1, -1, 31, -1, -1, -1],
    [-1, -1, -1, -1, -1, -1, -1, -1, -1,  7, -1, -1, -1, -1, -1, -1],
    [-1, -1, -1, -1, -1, -1, -1, -1, -1, -1, -1, -1, -1, -1, -1, -1],
    [-1, -1, -1, -1, -1, -1, -1, -1, -1, -1, -1, -1, -1, -1, -1, -1] 
  ],
  "scroll_2":"This is the truth and the truth is so:\nYou expect \"good\" things and in your false expectation, weep when \"bad\" things come. There are no good and bad things. Things just are.",
  "map_3":[
    [10, 10, 10, 10, 10, 10,  9, 17, 18, 9, 10, 10, 10, 10, 10, 10],
    [10,  3, 22,  3,  3,  3,  1, 12, 12, 1,  3,  3,  3, 22,  3, 10],
    [10, 25, 26, 26, 26, 26, 26, 26, 26, 26, 26, 26, 26, 26, 26, 10],
    [10, 25, 26, 26, 26, 26, 26, 26, 26, 26, 26, 26, 26, 26, 26, 10],
    [10, 25, 26, 26, 30, 30, 30, 30, 30, 30, 30, 30, 26, 26, 26, 10],
    [10, 25, 26, 30, 26, 26, 26, 26, 26, 26, 26, 26, 30, 26, 26, 10],
    [10, 25, 26, 26, 30, 30, 30, 26, 26, 30, 30, 30, 26, 26, 26, 10],
    [10, 25, 26, 26, 26, 26, 26, 26, 26, 26, 26, 26, 26, 26, 26, 10],
    [10, 25, 26, 26, 26, 26, 26, 26, 26, 26, 26, 26, 26, 26, 26, 10],
    [10, 25, 26, 26, 26, 26, 26, 26, 26, 26, 26, 26, 26, 26, 26, 10],
    [10, 25, 26, 26, 26, 26, 26, 26, 26, 26, 26, 26, 26, 26, 26, 10],
    [10, 10, 10, 10, 10, 10, 10, 10, 10, 10, 10, 10, 10, 10, 10, 10]
  ],
  "items_3":[
    [-1, -1, -1, -1, -1, -1, -1, -1, -1, -1, -1, -1, -1, -1, -1, -1],
    [-1, -1, 33, -1, -1, -1, -1, -1, -1, -1, -1, -1, -1, 33, -1, -1],
    [-1, -1, -1, -1, -1,  7, -1, -1, -1, -1, -1,  7, -1, -1, -1, -1],
    [-1, -1, -1, -1, -1, -1, -1, -1, -1, -1, -1, -1, -1, -1, -1, -1],
    [-1, -1, -1, -1, -1, -1, -1, -1, -1, -1, -1, -1, -1, -1, -1, -1],
    [-1, -1, -1, -1, -1, -1,  7, -1,  8, -1, -1, -1, -1, -1, -1, -1],
    [-1, -1, -1, -1, -1, -1, -1, -1, -1, -1, -1, -1, -1, -1, -1, -1],
    [-1, -1, -1, -1, -1, -1, -1, -1, -1, -1, -1, -1, -1, -1, -1, -1],
    [-1, -1, -1, -1, 32, -1, -1, -1, -1, -1, -1, -1, 31, -1, -1, -1],
    [-1, -1, -1, -1, -1, -1, -1, -1, -1,  7, -1, -1, -1, -1, -1, -1],
    [-1, -1, -1, -1, -1, -1, -1, -1, -1, -1, -1, -1, -1, -1, -1, -1],
    [-1, -1, -1, -1, -1, -1, -1, -1, -1, -1, -1, -1, -1, -1, -1, -1] 
  ],
  "scroll_3":"So is the truth and the truth is such:\nYou have come too far. A glutenous fly drowning in too much honey that no longer tastes as sweet. Your mind is but a vessel for my world to bleed into.",
  "ending_a":"It was always there. Part of you always knew. You knew you shouldn't look, but you had to. You had to. You let go and wonder why you didn't do so sooner. Finally, at peace.",
  "ending_b":"There is nothing other than this, now. Big, big eyes stare at you expectantly. Don't they know? They command silently and you obey. You finally see, but it's not you anymore. Nothing remains of that person."
}