{
  "map_1":[
      [10, 10, 10, 10, 10, 10, 10, 10, 10, 10, 10, 10, 10, 10, 10, 10],
      [10,  3, 22,  3,  3,  3,  3,  3,  3,  3,  3,  3,  3, 22,  3, 10],
      [10, 25, 26, 26, 26, 26, 26, 26, 26, 26, 26, 26, 26, 26, 26, 10],
      [10, 25, 26, 26, 26, 26, 26, 26, 26, 26, 26, 26, 26, 26, 26, 10],
      [10, 25, 26, 26, 30, 30, 30, 30, 30, 30, 30, 30, 26, 26, 26, 10],
      [10, 25, 26, 30, 26, 26, 26, 26, 26, 26, 26, 26, 30, 26, 26, 10],
      [10, 25, 26, 26, 30, 30, 30, 26, 26, 30, 30, 30, 26, 26, 26, 10],
      [10, 25, 26, 26, 26, 26, 26, 26, 26, 26, 26, 26, 26, 26, 26, 10],
      [10, 25, 26, 26, 26, 26, 26, 26, 26, 26, 26, 26, 26, 26, 26, 10],
      [10, 25, 26, 26, 26, 26, 26, 26, 26, 26, 26, 26, 26, 26, 26, 10],
      [10, 25, 26, 26, 26, 26, 26, 26, 26, 26, 26, 26, 26, 26, 26, 10],
      [10, 10, 10, 10, 10, 10, 10, 10, 10, 10, 10, 10, 10, 10, 10, 10]
  ],
  "items_1":[
    [-1, -1, -1, -1, -1, -1, -1, -1, -1, -1, -1, -1, -1, -1, -1, -1],
    [-1, -1, -1, -1, -1, -1, -1, -1, -1, -1, -1, -1, -1, -1, -1, -1],
    [-1, -1, -1, -1, -1,  7, -1, -1, -1, -1, -1,  7, -1, -1, -1, -1],
    [-1, -1, -1, -1, -1, -1, -1, -1, -1, -1, -1, -1, -1, -1, -1, -1],
    [-1, -1, -1, -1, -1, -1, -1, -1, -1, -1, -1, -1, -1, -1, -1, -1],
    [-1, -1, -1, -1, -1, -1,  7, -1,  8, -1, -1, -1, -1, -1, -1, -1],
    [-1, -1, -1, -1, -1, -1, -1, -1, -1, -1, -1, -1, -1, -1, -1, -1],
    [-1, -1, -1, -1, -1, -1, -1, -1, -1, -1, -1, -1, -1, -1, -1, -1],
    [-1, -1, -1, -1, 32, -1, -1, -1, -1, -1, -1, -1, -1, -1, -1, -1],
    [-1, -1, -1, -1, -1, -1, -1, -1, -1,  7, -1, -1, -1, -1, -1, -1],
    [-1, -1, -1, -1, -1, -1, -1, -1, -1, -1, -1, -1, -1, -1, -1, -1],
    [-1, -1, -1, -1, -1, -1, -1, -1, -1, -1, -1, -1, -1, -1, -1, -1] 
  ]
}