{
    "1":[
        [10, 10, 10, 10, 10, 10, 10, 10, 10, 10, 10, 10, 10, 10, 10, 10],
        [10,  3, 22,  3,  3,  3,  3,  3,  3,  3,  3,  3,  3, 22,  3, 10],
        [10, 25, 26, 26, 26, 26, 26, 26, 26, 26, 26, 26, 26, 26, 26, 10],
        [10, 25, 26, 26, 26, 26, 26, 26, 26, 26, 26, 26, 26, 26, 26, 10],
        [10, 25, 26, 26, 30, 30, 30, 30, 30, 30, 30, 30, 26, 26, 26, 10],
        [10, 25, 26, 30, 26, 26, 26, 26, 26, 26, 26, 26, 30, 26, 26, 10],
        [10, 25, 26, 26, 30, 30, 30, 26, 26, 30, 30, 30, 26, 26, 26, 10],
        [10, 25, 26, 26, 26, 26, 26, 26, 26, 26, 26, 26, 26, 26, 26, 10],
        [10, 25, 26, 26, 26, 26, 26, 26, 26, 26, 26, 26, 26, 26, 26, 10],
        [10, 25, 26, 26, 26, 26, 26, 26, 26, 26, 26, 26, 26, 26, 26, 10],
        [10, 25, 26, 26, 26, 26, 26, 26, 26, 26, 26, 26, 26, 26, 26, 10],
        [10, 10, 10, 10, 10, 10, 10, 10, 10, 10, 10, 10, 10, 10, 10, 10]
      ]
}