{
  "prologue":"You are a reader - someone who can derive meaning from mere strokes forming all sorts of peculiar shapes.\n\nOnly you can read the ancient scrolls and find the Truth. But the ruins of your creators are suffocating. The stone looks like crying faces and the traps whisper your name sweetly.\n\nFor the sake of your own sanity, get out of there as soon as possible.",
  "map_1":[
      [10, 10, 10, 10, 10, 10,  9, 17, 18,  9, 10, 10, 10, 10, 10, 10],
      [10,  3,  3,  3,  3, 21,  1, 12, 12,  1, 21,  3,  3,  3,  3, 10],
      [10, 12, 12, 12, 12, 12, 12, 26, 26, 12, 12, 12, 12, 12, 12, 10],
      [10, 10, 10, 10, 26, 26, 26, 26, 26, 26, 26, 26, 10, 10, 10, 10],
      [10,  3, 22,  3, 30, 30, 30, 30, 30, 30, 30, 30,  3, 22,  3, 10],
      [10, 26, 30, 30, 29, 29, 29, 29, 29, 29, 29, 29, 30, 30, 26, 10],
      [10, 26, 29, 29, 29, 29, 29, 29, 29, 29, 29, 29, 29, 29, 26, 10],
      [10, 10, 10, 10, 29, 29, 29, 12, 12, 29, 29, 29, 10, 10, 10, 10],
      [10,  3, 22,  3, 29, 29, 29, 26, 26, 29, 29, 29,  3, 22,  3, 10],
      [10, 26, 26, 26, 26, 26, 26, 26, 26, 26, 26, 26, 26, 26, 26, 10],
      [10, 26, 26, 26, 26, 26, 26, 26, 26, 26, 26, 26, 26, 26, 26, 10],
      [10, 10, 10, 10, 10, 10, 10, 10, 10, 10, 10, 10, 10, 10, 10, 10]
  ],
  "items_1":[
    [-1, -1, -1, -1, -1, -1, -1, -1, -1, -1, -1, -1, -1, -1, -1, -1],
    [-1, -1, -1, -1, -1, -1, -1, -1, -1, -1, -1, -1, -1, -1, -1, -1],
    [-1, -1, -1, -1, -1, -1, -1, -1, -1, -1, -1, -1, -1, -1, -1, -1],
    [-1, -1, -1, -1, -1, -1, -1, -1, -1, -1, -1, -1, -1, -1, -1, -1],
    [-1, -1, 33, -1, -1, -1, -1, -1, -1, -1, -1, -1, -1, 33, -1, -1],
    [-1,  7, -1, -1, -1, -1, -1, 14, -1, -1, -1, -1, -1, -1,  7, -1],
    [-1,  7, -1, -1, -1, -1, -1, -1, -1, -1, -1, -1, -1, -1,  7, -1],
    [-1, -1, -1, -1, -1, -1, -1, -1, -1, -1, -1, -1, -1, -1, -1, -1],
    [-1, -1, 33, -1, -1, -1, -1, -1, -1, -1, -1, -1, -1, 33, -1, -1],
    [-1, -1, -1, -1, -1,  8, -1, -1, -1, -1, 31, -1, -1, -1, -1, -1],
    [-1, -1, -1, -1, -1, -1, -1, -1, -1, -1, -1, -1, -1, -1, -1, -1],
    [-1, -1, -1, -1, -1, -1, -1, -1, -1, -1, -1, -1, -1, -1, -1, -1] 
  ],
  "scroll_1_move":true,
  "scroll_1":"Such is the truth and the truth is this:\n\nYou are hurting, but be warned, it is here that you will feel the utmost pain.\nYour suffering isn't a punishment.",
  "map_2":[
    [10, 10, 10, 10, 10, 10,  9, 17, 18, 9, 10, 10, 10, 10, 10, 10],
    [10,  3, 22,  3, 21,  3,  1, 12, 12, 1,  3, 21,  3, 22,  3, 10],
    [10, 26, 26, 26, 26, 26, 26, 26, 26, 26, 26, 26, 26, 26, 26, 10],
    [10, 26, 26, 26, 26, 13, 13, 13, 13, 13, 13, 26, 26, 26, 26, 10],
    [10, 26, 26, 26, 13, 26, 26, 13, 13, 26, 26, 13, 26, 26, 26, 10],
    [10, 26, 26, 26, 13, 26, 26, 13, 13, 26, 26, 13, 26, 26, 26, 10],
    [10, 26, 26, 26, 13, 13, 13, 13, 13, 13, 13, 13, 26, 26, 26, 10],
    [10, 26, 26, 26, 26, 13, 13, 26, 26, 13, 13, 26, 26, 26, 26, 10],
    [10, 26, 26, 26, 26, 13, 13, 13, 13, 13, 13, 26, 26, 26, 26, 10],
    [10, 26, 26, 26, 26, 13, 26, 13, 13, 26, 13, 26, 26, 26, 26, 10],
    [10, 26, 26, 26, 26, 26, 26, 26, 26, 26, 26, 26, 26, 26, 26, 10],
    [10, 10, 10, 10, 10, 10, 10, 10, 10, 10, 10, 10, 10, 10, 10, 10]
  ],
 "items_2":[
     [-1, -1, -1, -1, -1, -1, -1, -1, -1, -1, -1, -1, -1, -1, -1, -1],
     [-1, -1, 33, -1, -1, -1, -1, -1, -1, -1, -1, -1, -1, 33, -1, -1],
     [-1, -1, -1, -1, -1, -1, -1, -1, -1, -1, -1, -1, -1, -1, -1, -1],
     [-1, -1, -1, -1, -1, 32, 32, 32, 32, 32, 32, -1, -1, -1, -1, -1],
     [-1, -1, -1, -1, 32, -1, -1, 32, 32, -1, -1, 32, -1, -1, -1, -1],
     [-1, -1, -1, -1, 32, -1,  7, 32, 32,  7, -1, 32, -1, -1, -1, -1],
     [-1, -1, -1, -1, 32, 32, 32, 32, 32, 32, 32, 32, -1, -1, -1, -1],
     [-1, -1, -1, -1, -1, 32, 32, 31, 14, 32, 32, -1, -1, -1, -1, -1],
     [-1, -1, -1, -1, -1, 32, 32, 32, 32, 32, 32, -1, -1, -1, -1, -1],
     [-1, -1, -1, -1, -1, 32, -1, 32, 32, -1, 32, -1, -1, -1, -1, -1],
     [-1, -1, -1, -1, -1, -1, -1, -1, -1, -1, -1, -1, -1, -1, -1, -1],
     [-1, -1, -1, -1, -1, -1, -1, -1, -1, -1, -1, -1, -1, -1, -1, -1] 
   ],
  "scroll_2_move":false,
  "scroll_2":"This is the truth and the truth is so:\n\nYou expect \"good\" things and in your false expectation, weep when \"bad\" things come.\nThere are no good and bad things.\nThings just are.",
  "map_3":[
    [10, 10, 10, 10, 10, 10,  9, 17, 18, 9, 10, 10, 10, 10, 10, 10],
    [10,  3, 22,  3,  3,  3,  1, 12, 12, 1,  3,  3,  3, 22,  3, 10],
    [10, 25, 26, 26, 26, 26, 26, 26, 26, 26, 26, 26, 26, 26, 26, 10],
    [10, 25, 26, 26, 10, 10, 10, 10, 10, 10, 10, 10, 26, 26, 26, 10],
    [10, 25, 26, 26, 10,  3,  3,  3,  3,  3,  3, 10, 26, 26, 26, 10],
    [10, 25, 26, 26,  3, 26, 26, 26, 26, 26, 26,  3, 26, 26, 26, 10],
    [10, 25, 26, 26, 26, 26, 26, 26, 26, 26, 26, 26, 26, 26, 26, 10],
    [10, 25, 26, 26, 10, 26, 26, 26, 26, 26, 26, 10, 26, 26, 26, 10],
    [10, 25, 26, 26, 10, 10, 10, 10, 10, 10, 10, 10, 26, 26, 26, 10],
    [10, 25, 26, 26,  3,  3,  3,  3,  3,  3,  3,  3, 26, 26, 26, 10],
    [10, 25, 26, 26, 26, 26, 26, 26, 26, 26, 26, 26, 26, 26, 26, 10],
    [10, 10, 10, 10, 10, 10, 10, 10, 10, 10, 10, 10, 10, 10, 10, 10]
  ],
  "items_3":[
    [-1, -1, -1, -1, -1, -1, -1, -1, -1, -1, -1, -1, -1, -1, -1, -1],
    [-1, -1, 33, -1, -1, -1, -1, -1, -1, -1, -1, -1, -1, 33, -1, -1],
    [-1, -1, -1, -1, -1, -1, -1, -1, -1, -1, -1, -1, -1, -1, -1, -1],
    [-1, -1, 14, -1, -1, -1, -1, -1, -1, -1, -1, -1, -1, -1, -1, -1],
    [-1, -1, -1, -1, -1, -1, -1, -1, -1, -1, -1, -1, -1, -1, -1, -1],
    [-1, -1, -1, -1, -1, -1, -1,  7,  7, -1, -1, -1, -1, -1, -1, -1],
    [-1, -1, -1, -1, -1, -1,  7, -1, -1,  7, -1, -1, -1, -1, -1, -1],
    [-1, -1, -1, -1, -1, -1, -1,  7,  7, -1, -1, -1, -1, -1, -1, -1],
    [-1, -1, -1, -1, -1, -1, -1, -1, -1, -1, -1, -1, -1, -1, -1, -1],
    [-1, -1, -1, -1, -1, -1, -1, -1, -1, -1, -1, -1, -1,  1, -1, -1],
    [-1, -1, -1, -1, -1, -1, -1, -1, -1, -1, -1, -1, -1, -1, -1, -1],
    [-1, -1, -1, -1, -1, -1, -1, -1, -1, -1, -1, -1, -1, -1, -1, -1] 
  ],
  "scroll_3_move":false,
  "scroll_3":"So is the truth and the truth is such:\n\nYou have come too far. A glutenous fly drowning in too much honey that no longer tastes as sweet.\nYour mind is but a vessel for my world to bleed into.",
  "ending_n":"It was always there. Part of you always knew. You knew you shouldn't look, but you had to. You had to. You let go and wonder why you didn't do so sooner. Finally, at peace.",
  "ending_m":"There is nothing other than this, now. Big, big eyes stare at you expectantly. Don't they know? They command silently and you obey. You finally see, but it's not you anymore. Nothing remains of that person.",
  "ending_p":"Your mind was not ready.\n Your jaw clenches hard enough to break your teeth as your eyes roll back.\n\n You need the scroll's knowledge to move forward."
}